############################
#                          #
#            ...........   #
###  #######################
#      #    ..             #
#         ##    #   ####   #
###########     #          #
#         #     #          #
#         #     #          #
#         #######          #
#                          #
############################